111111111111111
10P1C0001E00001
101111100111001
101C00100001001
101110000000001
100000110011001
100001C001111C1
111111111111111
