11111111111111111111111111111111
1P1C00100000000000000000000000E1
10010100111000000001000000000001
10000000101010000010000000000001
100000000001C0000010000000100001
10000000001111011110100101011101
1000000001000000000001100000C101
11111111111111111111111111111101
10000000000000000000000000000001
10000000000000000000000000000001
10000000000000000000000000000001
11111000000111111111111111011111
100000000000000000000000010010C1
10000100111111001111000001000001
100101010001C1100000100000100111
101C0000010000001110000000011111
11111111111111111111111111111111
